10 10
||||||||||
         |
||| ||||||
| | |    |
| | | ||||
|        |
||||||| ||
|     | ||
| | |    |
||||||||||
8 3
